Tilemap
60,60
15,15
59,59,60,59,1194,1194,1194,1057,1194,1194,4,304,308,309,4
60,59,1194,1194,161,137,1194,1057,966,1194,11,374,373,372,11
59,1194,161,26,163,1194,162,1057,1194,162,6,372,44,374,6
1194,163,1194,161,1194,1194,1194,1057,1194,1194,1194,1194,1123,994,1194
1194,1194,26,1194,1194,1194,26,1158,1159,1159,1159,1025,1094,1159,1093
1194,1194,162,26,63,26,26,1057,1194,1194,1194,1194,1194,1194,1194
163,1194,1194,1194,163,1194,1194,1057,1194,1194,4,4,4,4,149
1025,1025,1025,1025,1025,1025,1025,1026,966,1194,11,4,4,1024,1025
1194,1194,1194,1194,162,1194,161,1057,1194,162,6,4,4,1057,6
1194,1194,163,26,63,1194,1194,1057,1194,1194,1024,1025,1025,1160,1194
1194,1194,1194,1194,161,1194,1194,1158,1159,1159,1160,63,1194,1194,1194
1194,63,1194,1194,1194,64,1194,1057,1194,1194,1194,1194,1194,1194,1194
1194,1194,1194,163,26,1194,1194,1057,1194,1194,63,1194,161,1194,1194
1194,63,137,1194,1194,163,163,1057,1194,1194,161,1194,1194,137,1194
1194,1194,1194,1194,1194,1194,1194,1057,1194,1194,26,1194,162,1194,63
