Tilemap
60,60
15,15
1374,1338,1344,1344,1344,1344,1344,1344,1344,1340,1374,1374,1374,1374,56
136,1375,1050,1081,1051,1004,1004,1004,52,1375,1374,1374,103,1374,56
1374,1375,1004,1004,1004,1004,1004,1004,1004,1375,1374,1374,1374,1374,56
1374,1375,1050,1081,1051,1004,1004,1021,1004,1375,1374,1374,136,1374,56
1374,1375,1004,1004,1004,1004,1004,1054,1004,1375,1374,136,1374,1374,56
136,1375,1050,1081,1051,1004,1004,1087,1004,1375,1374,1374,1374,1374,56
1374,1404,1344,1344,1344,1344,79,1344,1344,1406,1374,1374,1374,1374,56
1374,1374,1374,1374,1374,1374,763,1374,1374,1374,1374,1374,860,793,122
1374,136,1374,1374,1374,655,763,1374,136,1374,655,1374,763,1374,56
1374,1374,1374,103,1374,1374,763,1374,1374,1374,1374,1374,763,1374,56
1374,1374,1374,1374,1374,1374,795,796,796,793,793,793,798,1374,56
1374,655,1374,136,1374,1374,795,796,797,1374,1374,1374,1374,1374,56
1374,1374,1374,1374,1374,136,795,796,797,1374,1374,655,1374,1374,56
1374,1374,655,136,1374,1374,795,796,797,1374,103,1374,1374,136,56
1374,1374,1374,1374,1374,1374,795,796,797,1374,1374,655,1374,1374,56
