Tilemap
60,60
15,15
267,267,266,267,267,265,265,365,265,265,266,266,267,266,267
266,268,266,268,266,265,265,265,365,265,266,266,268,267,266
267,267,267,267,267,265,365,364,265,265,267,267,267,268,266
267,266,268,267,265,265,265,265,364,265,265,266,266,266,267
267,266,267,265,265,265,364,366,265,265,265,265,268,267,267
268,266,265,265,265,265,265,364,265,265,265,265,265,265,266
265,265,265,265,265,364,265,265,265,265,265,265,300,300,265
265,265,265,265,265,365,265,265,265,265,265,265,265,300,300
265,265,265,364,265,265,265,265,265,265,265,300,265,301,265
265,265,265,265,265,265,265,265,265,265,265,300,300,265,265
265,265,265,265,265,265,265,266,267,266,266,265,265,300,300
265,265,265,265,267,266,266,268,267,267,266,267,265,300,265
265,265,265,267,267,268,266,266,268,266,266,268,267,266,265
265,267,267,267,266,266,266,268,266,267,267,267,268,267,267
267,267,266,266,268,267,267,267,267,268,267,266,267,267,266
