Tilemap
60,60
15,15
594,594,594,196,594,594,195,1061,594,194,594,59,60,59,60
162,1478,1027,1027,1090,1027,1027,1160,594,162,594,594,60,59,59
594,594,95,594,1061,594,163,963,594,594,594,161,343,594,59
594,594,161,594,1061,161,594,963,162,594,161,337,339,344,594
594,163,594,162,1061,594,594,163,594,594,163,340,45,341,594
594,161,594,163,1061,594,161,963,162,161,161,594,1061,594,161
594,594,161,594,1158,1025,1025,1028,594,594,594,594,1061,594,594
162,161,594,162,1057,162,594,1156,1027,1027,1027,1027,1094,1159,1159
594,594,594,594,1125,594,594,5,594,594,1170,1170,1168,1170,1170
69,1243,1039,1039,1243,1039,38,1243,163,594,1170,160,160,160,1170
1039,1276,183,1039,1276,1039,234,1276,162,594,1170,160,160,160,1170
1039,1276,1039,1039,1276,214,1039,1276,594,594,1170,1170,1170,1170,1170
234,1276,1039,37,1276,1039,1039,1039,163,137,594,594,161,163,594
37,1276,1039,102,1276,1039,182,1276,594,594,163,594,594,594,594
1039,1309,182,1039,1309,1039,1039,1309,234,594,163,163,162,594,163
6
d,2,2,Water Well,The water well whispers a wonderfully whimsical wail.
d,3,11,Here lies Edgar Smith,Passed 1432, Know for his hatried of Larry Williams.
d,3,15,Here lies Larry Williams,Passed 1433, Know for his love of cheese.
d,6,12,*e** l*es Je**m* **r***gt*n,The text is to worn to read. You can only decipher the words (Greedy Grinner)
d,7,14,Here lies Caleb Richards,He didn't have that dog in him. 
d,13,5,Nuclear Fallout Shelter,(You never know when it could be usefull)
2
b,3,12
s,4,2