Tilemap
60,60
15,15
900,900,900,900,900,900,900,764,900,900,900,900,900,900,900
900,900,900,900,654,900,900,764,900,900,653,900,900,900,900
900,900,900,900,68,900,900,764,900,860,864,762,900,656,900
900,103,490,900,900,900,900,764,900,765,900,764,900,900,900
900,900,805,806,658,900,900,764,900,765,656,764,900,136,900
900,900,838,839,840,841,900,764,900,896,771,765,900,900,900
900,870,871,872,872,830,831,828,900,900,900,732,490,900,900
900,903,904,905,872,874,900,764,900,38,900,731,900,490,900
900,658,900,938,939,900,900,764,900,900,900,764,900,900,900
900,900,900,900,900,657,900,764,900,645,574,609,610,900,900
900,900,653,900,37,900,900,764,900,900,607,641,675,900,900
900,900,900,900,900,900,900,764,900,657,707,673,708,900,900
900,900,900,900,900,101,900,764,900,900,900,900,900,900,900
900,900,490,654,900,900,900,764,900,900,900,136,656,900,900
900,900,900,900,900,900,900,764,900,900,900,900,900,900,900
2
d,2,4,Trio of rocks,"Move along pal, nothing to see here."
d,10,10,Oasis shop,(Out to collect more desert)